R000#0#0###0###
0##000#00000000
00#0##00##0#0#0
0#00000###0#0#0
00####0##0#000#
#000##00#0###00
#0#0####00000##
#0#0#0000###0#0
000##0##0#000#0
#0##00000#0###0
#000####0#0000#
###0#0000###000
#000#0######00#
#0###0#00000000
#00000###0####G